Bad Luck (1960 film)

Bad Luck (Polish: Zezowate szczęście) is a 1960 Polish comedy film directed by Andrzej Munk. It was entered into the 1960 Cannes Film Festival.


== Cast ==
Bogumił Kobiela – Jan Piszczyk
Maria Ciesielska – Basia
Helena Dąbrowska – Wychówna
Barbara Lass – Jola Wrona-Wrońska (as Barbara Kwiatkowska)
Krystyna Karkowska – Wrona-Wrońska
Barbara Połomska – Zosia Jelonkowa
Irena Stalończyk – Irena Kropaczynska
Tadeusz Bartosik – Wasik
Henryk Bak – Director
Mariusz Dmochowski – UB Officer
Aleksander Dzwonkowski – Cezary Piszczyk
Edward Dziewoński – Jelonek
Tadeusz Janczar – Ens. Sawicki
Stanisław Jaworski – Watchmaker
Andrzej Krasicki – Witold Kropaczyński
Wojciech Lityński – Young Jan Piszczyk
Kazimierz Opaliński – Prison Governor
Jerzy Pichelski – Maj. Wrona-Wronski
Adam Pawlikowski – Ens. Osewski
Wojciech Siemion – Józef Kacperski
Maria Kaniewska - Anastazja Makulec
Jan Tadeusz Stanisławski – Chief Scout
Tadeusz Waczkowski – Manager Kozienicki


== References ==


== External links ==
Bad Luck on IMDb
Bad Luck at the Filmpolski.pl (in Polish)