N share

N-Shares (Chinese: Nè‚¡) refers to Chinese companies listed on the NYSE, NASDAQ, or the NYSE MKT. The term stands for New York. They may or may not be incorporated in China, but they have their main business operations in mainland China. Most of them are incorporated in Bermuda, the Cayman Islands, the British Virgin Islands, Nevada or Delaware. If they have been incorporated in mainland China, they trade as ADRs of H Shares. If they have been incorporated in Hong Kong, they trade as ADRs of Red chips. If they have been incorporated in Nevada, Delaware or Florida, they might have originated as reverse mergers. Most N-Shares are the American exchange equivalent of P-Chips.
However, the term N-Shares may only refer to private sector Chinese companies incorporated outside China, which excludes ADRs of H Shares or Red chips.
As of December 2010, the SEC is investigating frauds by publicly traded Chinese companies.


== N-Shares listed on the NYSE ==
Acorn International, Inc.	(NYSE: ATV) (Cayman Islands)
Agria Corp	(NYSE: GRO) (Cayman Islands)
Alibaba Group Holding Limited (NYSE: BABA) (Cayman Islands)
Aluminum Corp Of China Ltd	(NYSE: ACH) (China) (ADR of H share)
American Oriental Bioengineering Inc.	(NYSE: AOB) (Nevada)
American Dairy Inc. (aka Feihe International) 	(NYSE: ADY) (Utah)
China Digital TV Holding Co., Ltd.	(NYSE: STV) (Cayman Islands)
China Life Insurance	(NYSE: LFC) (China) (ADR of H share)
China Mobile Ltd	(NYSE: CHL) (Hong Kong) (ADR of Red chip)
China National Offshore Oil Corp Ltd	(NYSE: CEO)
China Nepstar Chain Drugstore Ltd.	(NYSE: NPD)
China Petroleum & Chemical Corp	(NYSE: SNP)
China Southern Airlines Co Ltd	(NYSE: ZNH)
China Telecom Corp Ltd	(NYSE: CHA)
China Unicom Ltd	(NYSE: CHU)
China Yuchi International Limited	(NYSE: CYD)
E-House (China) Holdings Limit	(NYSE: EJ)
General Steel Holdings Inc	(NYSE: GSI)
Giant Interactive Group Inc.	(NYSE: GA)
Guangshen Railway Co Ltd	(NYSE: GSH)
Gushan Environmental Energy Ltd	(NYSE: GU)
Huaneng Power International Inc	(NYSE: HNP)
Ldk Solar Co., Ltd.	(NYSE: LDK)
Mindray Medical International Limited	(NYSE: MR)
New Oriental Education & Technology Group	(NYSE: EDU)
Noah Education Holdings Ltd.	(NYSE: NED)
Petrochina Co Ltd	(NYSE: PTR)
Qiao Xing Mobile Communication Co., Ltd.	(NYSE: QXM)
Rene Sola Ltd	(NYSE: SOL)
Semiconductor Manufacturing International	(NYSE: SMI)
Simcere Pharmaceutical Group	(NYSE: SCR)
Sinopec Shanghai Petrochemical Co Ltd	(NYSE: SHI)
Suntech Power	(NYSE: STP)
Trina Solar Limited (Trina)	(NYSE: TSL)
Vance Info Technologies Inc.	(NYSE: VIT)
Wsp Holdings Ltd	(NYSE: WH)
Wuxi Pharma Tech (Cayman) Inc	(NYSE: WX)
Xinyuan Real Estate Co Ltd	(NYSE: XIN)
Yanzhou Coal Mining Co Ltd	(NYSE: YZC)
Yingli Green Energy Holding Company Limited	(NYSE: YGE)


== N-Shares listed on NASDAQ ==
3Sbio Inc.	(NASDAQ: SSRX)
51Job Inc.	(NASDAQ: JOBS)
Actions Semiconductor Co., Ltd.	(NASDAQ: ACTS)
Airmedia Group Inc.	(NASDAQ: AMCN)
Asiainfo Holdings Inc.	(NASDAQ: ASIA)
Ata Inc.	(NASDAQ: ATAI)
Baidu.Com, Inc.	(NASDAQ: BIDU)
Canadian Solar Inc (Headquartered in Ontario, manufacturing operations in China).	(NASDAQ: CSIQ)
China Automotive Systems Inc.	(NASDAQ: CAAS)
China Bak Battery, Inc.	(NASDAQ: CBAK)
China Direct Industries, Inc	(NASDAQ: CDII)
China Finance Online Co. Ltd.	(NASDAQ: JRJC)
China Grentech Corp. Ltd.	(NASDAQ: GRRF)
China Medical Technologies Inc.	(NASDAQ: CMED)
China Natural Resources, Inc.	(NASDAQ: CHNR)
China Precision Steel, Inc.	(NASDAQ: CPSL)
China Sky One Medical, Inc.	(NASDAQ: CSKI)
China Sunergy Co., Ltd.	(NASDAQ: CSUND)
China Techfaith Wireless Communication T	(NASDAQ: CNTF)
China Technology Development Group Corpo	(NASDAQ: CTDC)
Chinacast Education Corp	(NASDAQ: CAST)
Chinaedu Corp	(NASDAQ: CEDU)
Cninsure Inc.	(NASDAQ: CISG)
Comtech Group Inc.	(NASDAQ: COGO)
Ctrip.Com International Ltd	(NASDAQ: CTRP)
E-Future Information Technology Inc.	(NASDAQ: EFUT)
Elong Inc.	(NASDAQ: LONG)
Focus Media Holding	(NASDAQ: FMCN)
Fushi Copperweld, Inc.	(NASDAQ: FSIN)
Fuwei Films (Holdings) Co., Ltd.	(NASDAQ: FFHL)
Global Sources Ltd.	(NASDAQ: GSOL)
Hanwha Solarone Co., Ltd.	(NASDAQ: HSOL)
Home Inns & Hotels Management Inc.	(NASDAQ: HMIN)
Ja Solar Holdings Co., Ltd.	(NASDAQ: JASO)
JD.com, Inc. (NASDAQ: JD)
Kandi Technologies Corp	(NASDAQ: KNDI)
Kongzhong Corp.	(NASDAQ: KONG)
Ku6 Media Co. Ltd.	(NASDAQ: KUTV)
Linktone Ltd	(NASDAQ: LTON)
Melco Pbl Entertainment (Macau) Limited	(NASDAQ: MPEL)
Netease.Com	(NASDAQ: NTES)
Ninetowns Internet Technology Group Comp	(NASDAQ: NINE)
Origin Agritech Limited	(NASDAQ: SEED)
Perfect World Co Ltd	(NASDAQ: PWRD)
Qiao Xing Universal Telephone, Inc.	(NASDAQ: XING)
Shanda Interactive Entertainment Ltd	(NASDAQ: SNDA)
Sina Corporation	(NASDAQ: SINA)
Sohu Com Inc	(NASDAQ: SOHU)
Sorl Auto Parts Inc	(NASDAQ: SORL)
Spreadtrum Communications, Inc.	(NASDAQ: SPRD)
Sutor Technology Group Ltd	(NASDAQ: SUTR)
Telestone Technologies Corp	(NASDAQ: TSTC)
The9 Limited	(NASDAQ: NCTY)
Vimicro International Corporation	(NASDAQ: VIMC)
Visionchina Media Inc.	(NASDAQ: VISN)
Yucheng Technologies Limited	(NASDAQ: YTEC)


== N-Shares listed on the NYSE MKT ==
China Shenghuo Pharmaceutical Holdings	(AMEX: KUN)
Jinpan International Ltd.	(AMEX: JST)
Minco Gold Corp	(AMEX: MGH)
Sinovac Biotech Ltd	(AMEX: SVA)


== See also ==
Chip
A share
B share
H share
Red chip
P chip
S chip
N share
L share
G share
China Concepts Stock
S-Chips Scandals


== References ==